{
	"id": 1,
	"mapName": "brock point",
	"mapAuthor": "Simizu",
	"mapDescription": "This map is created for test",
	"mapSize": { "x": 15, "y": 15 },
	"mapInfo": {
		"blank": 0,
		"target": 1,
		"block": 1,
		"item": 1,
		"warp": 1
	},
	"startPosition": 
	{ 
		"C": {"x": 8, "y": 8},
	},
	"players": 1,
	"map": [
		[2, 2, 2, 2, 2, 2, 2, 2, 2, 2, 2, 2, 2, 2, 2],
		[2, 0, 0, 0, 0, 0, 0, 0, 0, 0, 0, 0, 0, 0, 2],
		[2, 0, 3, 3, 3, 3, 3, 3, 3, 3, 3, 3, 3, 0, 2],
		[2, 0, 3, 2, 2, 2, 2, 0, 2, 2, 2, 2, 3, 0, 2],
		[2, 0, 3, 2, 1, 1, 1, 1, 1, 1, 1, 2, 3, 0, 2],
		[2, 0, 3, 2, 1, 2, 2, 0, 2, 2, 1, 2, 3, 0, 2],
		[2, 0, 3, 2, 1, 2, 1, 1, 1, 2, 1, 2, 3, 0, 2],
		[2, 0, 3, 2, 1, 2, 1, ME,1, 2, 1, 2, 3, 0, 2],
		[2, 0, 3, 2, 1, 2, 1, 1, 1, 2, 1, 2, 3, 0, 2],
		[2, 0, 3, 2, 1, 2, 2, 0, 2, 2, 1, 2, 3, 0, 2],
		[2, 0, 3, 2, 1, 1, 1, 1, 1, 1, 1, 2, 3, 0, 2],
		[2, 0, 3, 2, 2, 2, 2, 0, 2, 2, 2, 2, 3, 0, 2],
		[2, 0, 3, 3, 3, 3, 3, 3, 3, 3, 3, 3, 3, 0, 2],
		[2, 0, 0, 0, 0, 0, 0, 0, 0, 0, 0, 0, 0, 0, 2],
		[2, 2,,2, 2, 2, 2, 2, 2, 2, 2, 2, 2, 2, 2, 2]

	]
}