{
	"id": 2,
	"mapName": "testMap2",
	"mapAuthor": "",
	"mapDescription": "This map is created for test",
	"mapSize": { "x": 20, "y": 20 },
	"mapInfo": {
		"blank": 0,
		"target": 1,
		"block": 2,
		"item": 3,
		"warp": 20
	},
	"startPosition": 
	{ 
		"C": {"x": 4, "y": 4},
		"H": {"x":16, "y":16},
		
	},
	"players": 2,
	"map": [                       10 11
		[0, 0, 0, 0, 0, 0, 0, 0, 0, 0, 0, 0, 0, 0, 0, 0, 0, 0, 0, 0],
		[0, 2, 2, 2, 2, 2, 2, 2, 2, 2, 2, 2, 2, 2, 2, 2, 2, 2, 2, 0],
		[0, 2, 1, 1, 1, 0, 0, 0, 0, 0, 0, 0, 0, 0, 0, 1, 1, 1, 2, 0],
		[0, 2, 1, c, 1, 0, 0, 0, 0,33,33, 0, 0, 0, 0, 1, 3, 1, 2, 0],
		[0, 2, 1, 1, 1, 0, 0, 0, 0, 0, 0, 0, 0, 0, 0, 1, 1, 1, 2, 0],
		[0, 2, 0, 0, 0, 1, 1, 1, 1, 1, 1, 1, 1, 1, 1, 0, 0, 0, 2, 0],
		[0, 2, 0, 0, 0, 1, 2, 2, 2, 3, 3, 2, 2, 2, 1, 0, 0, 0, 2, 0],
		[0, 2, 0, 0, 0, 1, 2, 0, 0, 1, 1, 0, 0, 2, 0, 0, 0, 0, 2, 0],
		[0, 2, 0, 0, 0, 1, 2, 0, 0, 1, 1, 0, 0, 2, 0, 0, 0, 0, 2, 0],
		[0, 2, 0,30, 0, 1, 3, 1, 1, 1, 1, 1, 1, 3, 0, 0,31, 0, 2, 0],
        [0, 2, 0,30, 0, 1, 3, 1, 1, 1, 1, 1, 1, 3, 0, 0,31, 0, 2, 0],
		[0, 2, 0, 0, 0, 1, 2, 0, 0, 1, 1, 0, 0, 2, 0, 0, 0, 0, 2, 0],
		[0, 2, 0, 0, 0, 1, 2, 0, 0, 1, 1, 0, 0, 2, 0, 0, 0, 0, 2, 0],
		[0, 2, 0, 0, 0, 1, 2, 2, 2, 3, 3, 2, 2, 2, 1, 0, 0, 0, 2, 0],
		[0, 2, 0, 0, 0, 1, 1, 1, 1, 1, 1, 1, 1, 1, 1, 0, 0, 2, 2, 0],
		[0, 2, 1, 1, 1, 0, 0, 0, 0, 0, 0, 0, 0, 0, 0, 1, 1, 1, 2, 0],
		[0, 2, 1, 3, 1, 0, 0, 0, 0,32,32, 0, 0, 0, 0, 1, H, 1, 2, 0],
		[0, 2, 1, 1, 1, 0, 0, 0, 0, 0, 0, 0, 0, 0, 0, 1, 1, 1, 2, 0],
		[0, 2, 2, 2, 2, 2, 2, 2, 2, 2, 2, 2, 2, 2, 2, 2, 2, 2, 2, 0],
		[0, 0, 0, 0, 0, 0, 0, 0, 0, 0, 0, 0, 0, 0, 0, 0, 0, 0, 0, 0]
	]
}
