{
	"id": 1,
	"mapName": "fiestMap",
	"mapAuthor": "takahasi",
	"mapDescription": "This map is created for test",
	"mapSize": { "x": 13, "y": 13 },
	"mapInfo": {
		"blank": 0,
		"target": 1,
		"block": 1,
		"item": 1,
		"warp": 1
	},
	"startPosition": 
	{ 
		"C": {"x": 5, "y": 5},
		
	},
	"players": 1,
	"map": [
		[3, 3, 3, 3, 3, 3, 3, 3, 3, 3, 3, 3, 3],
		[3, 0, 3, 2, 2, 2, 2, 2, 2, 2, 3, 0, 3],
		[3, 3, 0, 0, 0, 0, 0, 0, 0, 0, 0, 3, 3],
		[3, 2, 1, 0, 0, 0, 0, 0, 0, 0, 1, 2, 3],
		[3, 2, 0, 1, 0, 0, 0, 0, 0, 1, 0, 2, 3],
		[3, 2, 0, 0, 1, 1, 1, 1, 1, 0, 0, 2, 3],
		[3, 2, 3, 0, 0, 1, c, 1, 0, 0, 3, 2, 3],
		[3, 2, 0, 0, 0, 1, 1, 1, 0, 0, 0, 2, 3],
		[3, 2, 0, 0, 1, 0, 0, 0, 1, 0, 0, 2, 3],
		[3, 2, 0, 1, 0, 0, 0, 0, 0, 1, 0, 2, 3],
        [3, 3, 1, 0, 0, 0, 0, 0, 0, 0, 1, 3, 3],
        [3, 0, 3, 2, 2, 2, 2, 2, 2, 2, 3, 0, 3], 
        [3, 3, 3, 3, 3, 3, 3, 3, 3, 3, 3, 3, 3]   
	]
            
    
}
