{
	"id": 1,
	"mapName": "testMap",
	"mapAuthor": "fnit",
	"mapDescription": "This map is created for test",
	"mapSize": { "x": 19, "y": 19 },
	"mapInfo": {
		"blank": 0,
		"target": 1,
		"block": 2,
		"item": 3,
		"warp": 20
	},
	"startPosition": 
	{ 
		"C": {"x": 2, "y": 2}
	},
	"players": 1,
	"map": [
		[2, 2, 2, 2, 2, 3, 3, 3, 3, 3, 3, 3, 3, 3, 2, 2, 2, 2, 2],
		[2, 3, 1, 2, 0, 2, 1, 1, 3, 3, 3, 1, 1, 2, 0, 2, 3, 1, 2],
		[2, 1, 3, 2, 0, 0, 2, 1, 1, 1, 1, 1, 2, 0, 0, 2, 1, 3, 2],
		[2, 0, 2, 2, 0, 0, 0, 2, 1, 1, 1, 2, 0  0, 0, 2, 2, 0, 2],
		[2, 1, 1, 1, 0, 0, 0, 0, 2, 1, 2, 0, 0, 0, 0, 1, 1, 1, 2],
		[2, 0, 0, 0, 1, 0, 0, 3, 0, 0, 0, 3, 0, 0, 1, 0, 0, 0, 2], 
		[2, 0, 0, 0, 0, 1, 0, 0, 2, 0, 2, 0, 0, 1, 0, 0, 0, 0, 2],
		[2, 0, 2, 0, 0, 0, 1, 0, 2, 0, 2, 0, 1, 0, 0, 0, 2, 0, 2],
        [2, 2, 0, 0, 0, 0, 0, 1, 1, 1, 1, 1, 0, 0, 0, 0, 0, 2, 2],
		[2, 3, 3, 3, 3, 3, 3, 0, 1, C, 1, 0, 3, 3, 3, 3, 3, 3, 2],
        [2, 2, 0, 0, 0, 0, 0, 1, 1, 1, 1, 1, 0, 0, 0, 0, 0, 2, 2],
        [2, 0, 2, 0, 0, 0, 1, 0, 2, 0, 2, 0, 1, 0, 0, 0, 2, 0, 2],
        [2, 0, 0, 0, 0, 1, 0, 0, 2, 0, 2, 0, 0, 1, 0, 0, 0, 0, 2],
        [2, 0, 0, 0, 1, 0, 0, 3, 0, 0, 0, 3, 0, 0, 1, 0, 0, 0, 2],
        [2, 1, 1, 1, 0, 0, 0, 0, 2, 1, 2, 0, 0, 0, 0, 1, 1, 1, 2],
        [2, 0, 2, 2, 0, 0, 0, 2, 1, 1, 1, 2, 0, 0, 0, 2, 2, 0, 2],
        [2, 3, 1, 2, 0, 0, 2, 1, 1, 1, 1, 1, 2, 0, 0, 2, 3, 1, 2],
        [2, 1, 3, 2, 0, 2, 1, 1, 3, 3, 3, 1, 1, 2, 0, 2, 1, 3, 2],
        [2, 2, 2, 2, 2, 3, 3, 3, 3, 3, 3, 3, 3, 3, 2, 2, 2, 2, 2]
	]
}