{
	"id": 1,
	"mapName": "mapm",
	"mapAuthor": "m.chihiro",
	"mapDescription": "This map is created for test",
	"mapSize": { "x": 20, "y": 20 },
	"mapInfo": {
		"blank": 0,
		"target": 1,
		"block": 2,
		"item": 3,
		"warp": 1
	},
	"startPosition": 
	{ 
		"C": {"x": 13, "y": 4}
	},
	"players": 1,
	"map": [
		[0, 0, 0, 2, 2, 2, 2, 2, 2, 2, 2, 2, 2, 2, 2, 2, 2, 0, 0, 0],
        [0, 1, 1, 0, 0, 0, 0, 0, 0, 0, 0, 0, 0, 0, 0, 0, 0, 1, 1, 0],
        [0, 1, 2, 1, 0, 0, 1, 1, 1, 1, 1, 1, 1, 1, 0, 0, 1, 2, 1, 0],
        [2, 0, 1, 2, 2, 1, 1, 0, 1, 1, 1, 1, 0, 1, 1, 2, 2, 1, 0, 2],
        [2, 0, 1, 2, 1, 1, 1, 1, 1, 1, 1, 1, 1, 1, 1, 1, 2, 1, 0, 2],
        [2, 0, 0, 1, 1, 3, 0, 0, 0, 1, 1, 0, 0, 0, 3, 1, 1, 0, 0, 2],
        [2, 0, 1, 1, 0, 0, 3, 0, 0, 1, 1, 0, 0, 3, 0, 0, 1, 1, 0, 2],
        [2, 0, 1, 1, 0, 0, 0, 2, 0, 1, 1, 0, 2, 0, 0, 0, 1, 1, 0, 2],
        [2, 0, 1, 1, 0, 0, 0, 0, 0, 3, 3, 0, 0, 0, 0, 0, 1, 1, 0, 2],
        [2, 0, 1, 1, 3, 3, 3, 3, 3, 2, 2, 3, 3, 3, 3, 3, 1, 1, 0, 2],
        [2, 0, 1, 1, 3, 3, 3, 3, 3, 2, 2, 3, 3, 3, 3, 3, 1, 1, 0, 2],
        [2, 0, 1, 1, 0, 0, 0, 0, 0, 3, 3, 0, 0, 0, 0, 0, 1, 1, 0, 2],
        [2, 0, 1, 1, 0, 0, 0, 2, 0, 1, 1, 0, 2, 0, 0, 0, 1, 1, 0, 2],
        [2, 0, 1, 1, 0, 0, 3, 0, 0, 1, 1, 0, 0, 3, 0, 0, 1, 1, 0, 2],
        [2, 0, 0, 1, 1, 3, 0, 0, 0, 1, 1, 0, 0, 0, 3, 1, 1, 0, 0, 2],
        [2, 0, 1, 2, 1, 1, 1, 1, 1, 1, 1, 1, 1, 1, 1, 1, 2, 1, 0, 2],
        [2, 0, 1, 2, 2, 1, 1, 0, 1, 1, 1, 1, 0, 1, 1, 2, 2, 1, 0, 2],
        [0, 1, 2, 1, 0, 0, 1, 1, 1, 1, 1, 1, 1, 1, 0, 0, 1, 2, 1, 0],
        [0, 1, 1, 0, 0, 0, 0, 0, 0, 0, 0, 0, 0, 0, 0, 0, 0, 1, 1, 0],
        [0, 0, 0, 2, 2, 2, 2, 2, 2, 2, 2, 2, 2, 2, 2, 2, 2, 0, 0, 0]
	]
}