{
	"id": 1,
	"mapName": "map2",
	"mapAuthor": "mayama",
	"mapDescription": "This map is created for test",
	"mapSize": { "x": 15, "y": 15 },
	"mapInfo": {
		"blank": 0,
		"target": 1,
		"block": 2,
		"item": 3,
		"warp": 33
	},
	"startPosition": 
	{ 
		"C": {"x": 8, "y": 8},
	},
	"players": 1,
	"map": [
		[2, 3, 3, 3, 3, 3, 3, 2, 3, 3, 3, 3, 3, 3, 2],
		[3, 3, 1, 3, 1, 3, 1, 1, 1, 3, 1, 3, 1, 3, 3],
		[3, 1, 3, 3, 3, 0, 0, 1, 0, 0, 3, 3, 3, 1, 3],
		[3, 3, 3, 1, 1, 0, 0, 1, 0, 0, 1, 1, 3, 3, 3],
		[3, 1, 3, 1, 2, 1, 1, 1, 1, 1, 2, 1, 3, 1, 3],
		[3, 3, 0, 0, 1, 1, 0, 1, 0, 1, 1, 0, 0, 3, 3],
		[3, 1, 0, 0, 1, 0, 1, 1, 1, 0, 1, 0, 0, 1, 3],
		[2, 3, 1, 1, 1, 1, 1, 0, 1, 1, 1, 1, 1, 1, 2],
		[3, 1, 0, 0, 1, 0, 1, 1, 1, 0, 1, 0, 0, 1, 3],
		[3, 3, 0, 0, 1, 1, 0, 1, 0, 1, 1, 0, 0, 3, 3],
		[3, 1, 3, 1, 2, 1, 1, 1, 1, 1, 2, 1, 3, 1, 3],
		[3, 3, 3, 1, 1, 0, 0, 1, 0, 0, 1, 1, 3, 3, 3],
		[3, 1, 3, 3, 3, 0, 0, 1, 0, 0, 3, 3, 3, 1 3],
		[3, 3, 1, 3, 1, 3, 1, 1, 1, 3, 1, 3, 1, 3, 3],
		[2, 3, 3, 3, 3, 3, 3, 2, 3, 3, 3, 3, 3, 3, 2]
	]
}