{
	"id": 99,
	"mapName": "99map",
	"mapAuthor": "Kenji",
	"mapDescription": "This map is created for test",
	"mapSize": { "x": 21, "y": 21 },
	"mapInfo": {
		"blank": 0,
		"target": 0,
		"block": 0,
		"item": 0,
		"warp": 0
	},
	"startPosition": 
	{ 
		"C": {"x": 11, "y": 11},
	},
	"players": 1,
	"map": [


		[1, 3, 2, 1, 0, 0, 0, 0, 0, 1, 23, 1, 0, 0, 0, 0, 0, 1, 2, 3, 1],		
		[3, 3, 2, 1, 0, 0, 0, 0, 0, 1, 1, 1, 0, 0, 0, 0, 0, 1, 2, 3, 3],
		[2, 2, 3, 0, 0, 0, 0, 0, 0, 0, 0, 0, 0, 0, 0, 0, 0, 0, 3, 2, 2],
		[1, 1, 0, 0, 0, 0, 0, 0, 0, 0, 0, 0, 0, 0, 0, 0, 0, 0, 0, 1, 1],
		[0, 0, 0, 0, 3, 2, 3, 0, 0, 0, 2, 0, 0, 0, 3, 2, 3, 0, 0, 0, 0],
		[0, 0, 0, 0, 2, 2, 3, 0, 0, 2, 1, 2, 0, 0, 2, 2, 2, 0, 0, 0, 0],
		[0, 0, 0, 0, 2, 3, 3, 0, 0, 0, 2, 0, 0, 0, 2, 3, 2, 0, 0, 0, 0],
		[0, 0, 0, 0, 0, 0, 0, 0, 0, 0, 0, 0, 0, 0, 0, 0, 0, 0, 0, 0, 0],
		[0, 0, 0, 0, 0, 0, 0, 0, 0, 0, 0, 0, 0, 0, 0, 0, 0, 0, 0, 0, 0],
		[1, 1, 0, 0, 0, 3, 0, 0, 0, 1, 1, 1, 0, 0, 0, 2, 0, 0, 0, 1, 1],
		[20, 1, 0, 0, 3, 1, 3, 0, 0, 1, C, 1, 0, 0, 2, 1, 2, 0, 0, 1, 21],
		[1, 1, 0, 0, 0, 3, 0, 0, 0, 1, 1, 1, 0, 0, 0, 2, 0, 0, 0, 1, 1],
		[0, 0, 0, 0, 0, 0, 0, 0, 0, 0, 0, 0, 0, 0, 0, 0, 0, 0, 0, 0, 0],
		[0, 0, 0, 0, 0, 0, 0, 0, 0, 0, 0, 1, 0, 0, 0, 0, 0, 0, 0, 0, 0],
		[0, 0, 0, 0, 2, 3, 2, 0, 0, 0, 2, 0, 0, 0, 2, 3, 2, 0, 0, 0, 0],
		[0, 0, 0, 0, 2, 2, 2, 0, 0, 2, 1, 2, 0, 0, 2, 2, 2, 0, 0, 0, 0],
		[0, 0, 0, 0, 3, 2, 3, 0, 0, 0, 2, 0, 0, 0, 3, 2, 3, 0, 0, 0, 0],
		[1, 1, 0, 0, 0, 0, 0, 0, 0, 0, 0, 0, 0, 0, 0, 0, 0, 0, 0, 1, 1],
		[2, 2, 3, 0, 0, 0, 0, 0, 0, 0, 0, 0, 0, 0, 0, 0, 0, 0, 3, 2, 2],
		[3, 3, 2, 1, 0, 0, 0, 0, 0, 1, 1, 1, 0, 0, 0, 0, 0, 1, 2, 3, 3],
		[1, 3, 2, 1, 0, 0, 0, 0, 0, 1, 22, 1, 0, 0, 0, 0, 0, 1, 2, 3, 1]
	]
}