{
	"id": 1,
	"mapName": "sunrihgt",
	"mapAuthor": "Simizu",
	"mapDescription": "This map is created for test",
	"mapSize": { "x": 15, "y": 15 },
	"mapInfo": {
		"blank": 0,
		"target": 1,
		"block": 1,
		"item": 1,
		"warp": 1
	},
	"startPosition": 
	{ 
		"C": {"x": 15, "y": 15},
	},
	"players": 1,
	"map": [
		[0, 0, 0, 0, 0, 0, 0, 0, 0, 0, 0, 0, 0, 0, 0],
		[0, 0, 0, 0, 0, 0, 0, 0, 0, 0, 0, 0, 0, 0, 0],
		[0, 0, 3, 0, 0, 0, 0, 3, 0, 0, 0, 0, 3, 0, 0],
		[0, 0, 0, 2, 0, 0, 0, 2, 0, 0, 0, 2, 0, 0, 0],
		[0, 0, 0, 0, 1, 0, 0, 1, 0, 0, 1, 0, 0, 0, 0],
		[0, 0, 0, 0, 0, 3, 3, 3, 3, 3, 0, 0, 0, 0, 0],
		[0, 0, 0, 0, 0, 3, 1, 1, 1, 3, 0, 0, 0, 0, 0],
		[0, 0, 3, 2, 1, 3, 1, C, 1, 3, 1, 2, 3, 0, 0],
		[0, 0, 0, 0, 0, 3, 1, 1, 1, 3, 0, 0, 0, 0, 0],
		[0, 0, 0, 0, 0, 3, 3, 3, 3, 3, 0, 0, 0, 0, 0],
		[0, 0, 0, 0, 1, 0, 0, 1, 0, 0, 1, 0, 0, 0, 0],
		[0, 0, 0, 2, 0, 0, 0, 2, 0, 0, 0, 2, 0, 0, 0],
		[0, 0, 3, 0, 0, 0, 0, 3, 0, 0, 0, 0, 3, 0, 0],
		[0, 0, 0, 0, 0, 0, 0, 0, 0, 0, 0, 0, 0, 0, 0],
		[0, 0, 0, 0, 0, 0, 0, 0, 0, 0, 0, 0, 0, 0, 0]
	]
}